 Pastello bianco - Pinguini Tattici Nucleari 
Shakerando - Rhove 
Bellissima - Annalisa 
Giovani Wannabe - Pinguini Tattici Nucleari 
Quevedo: Bzrp Music Sessions, Vol. 52 - Bizarrap & Quevedo 
La Dolce vita - Fedez & Tananai & Mara Sattei 
Ricordi - Pinguini Tattici Nucleari 
Brividi - Mahmood & Blanco 
La Coda del diavolo - Rkomi & Elodie 
Dove si balla - Dargen D'Amico 
Finchè non mi seppelliscono - Blanco 
Tropicana - Boomdabash & Annalisa 
As it was - Harry Styles 
5 gocce - Irama feat. Rkomi 
Caramello - Rocco Hunt & Elettra Lamborghini & Lola Indigo 
Farfalle - Sangiovanni 
Bagno a mezzanotte - Elodie 
The Loneliest - Maneskin 
Crazy love - Marracash 
I'm good (Blue) - David Guetta & Bebe Rexha 
Panico - Lazza & Takagi e Ketra 
∞ Love - Marracash & Guè Pequeno 
I love you baby - Jovanotti & Sixpm 
Nostalgia - Blanco 
S!r! - tha Supreme feat. Lazza & Sfera Ebbasta 
Extasi - Fred De Palma 
Capri sun - Capo Plaza 
Ciao ciao - La Rappresentante di Lista 
Abissale - Tananai 
Mi fiderò - Marco Mengoni feat. Madame 
Uscito di galera - Lazza 
Ovunque sarai - Irama 
Baby Goddamn - Tananai 
Vieni nel mio cuore - Ultimo 
abcdefu - Gayle 
Heat waves - Glass Animals 
Unholy - Sam Smith & Kim Petras 
Don't you worry - Black Eyed Peas feat. Shakira & David Guetta 
Tribale - Elodie
Tití me preguntó - Bad Bunny
Propaganda - Fabri Fibra feat. Colapesce & Dimartino
Bam bam - Camila Cabello feat. Ed Sheeran
Hace calor [remix] - Kaleb Di Masi & Sfera Ebbasta & Rvfv & Omar Varela
Sapore - Fedez feat. Tedua 
Piove - Lazza & Sfera Ebbasta
Ferrari [remix] - James Hype & Miggy Dela Rosa & Lazza
Clap your hands - Kungs
Molotov - Lazza
Another love - Tom Odell 
!ly - tha Supreme feat. Coez
I ain't worried - OneRepublic
Supermodel - Maneskin
Ferrari - James Hype & Miggy Dela Rosa
Star walkin' (League of Legends Worlds anthem) - Lil Nas X
Insuperabile - Rkomi
Mamma mia - Sfera Ebbasta & Rvssian
Snap [italian] - Rosa Linn & Alfa
Pare - Ghali feat. Madame
Bones - Imagine Dragons
In the dark - Purple Disco Machine & Sophie and the Giants
No stress - Marco Mengoni
Viola - Fedez feat. Salmo
Enemy - Imagine Dragons & JID & League of Legends 
Tete - Ava feat. Medy & Villabanks
Hold me closer - Elton John & Britney Spears
About damn time - Lizzo
Mujer - Icy Subzero
Celestial - Ed Sheeran
Tutti i miei ricordi - Marco Mengoni
Hula-Hoop - Carl Brave & Noemi
Bubble - Takagi e Ketra feat. tha Supreme & Salmo
O forse sei tu - Elisa
Caos - Fabri Fibra & Lazza & Madame
Solite pare - Sick Luke & tha Supreme & Sfera Ebbasta
Take 4 - Shiva
Calm down - Rema
2 be loved (am I ready) - Lizzo
Camera 209 - Alessandra Amoroso & DB Boulevard
Humankind - Coldplay
Pensando a lei - Shiva
Overpass graffiti - Ed Sheeran 
Nemesi - Marracash & Blanco 
Snap - Rosa Linn
Ti va di stare bene - Ultimo
Late night talking - Harry Styles
Occhi rossi - Coez 
Lei - Neima Ezza feat. Rondodasosa
L'Eccezione - Madame
Pampampampampampampampam - Irama
Sesso occasionale - Tananai
Veleno - Guè Pequeno 
Tutte le notti - Tommaso Paradiso
La Vita splendida - Tiziano Ferro
Litoranea - Elisa & Matilda De Angelis
Break my soul - Beyoncè
Cancelo - Rhove
Bolero - Baby K feat. Mika
Hold my hand - Lady GaGa
Se lo senti lo sai - Jovanotti
Pistole nella Fendi - Niko Pandetta & Tempoxso & Janax